11111111111111111111
1E0C0000000000000001
110010000011C1100001
1101100000000C000001
110C1000000011110001
1C001000000000000001
1C111011110000C00001
1C00C000111000C00001
1100C000CC0000P00001
11011000000001011101
1CCCCC00000001CCCC01
11111111111111111111
